   0  1  2  3  4  5  6  7  8  9  10 11 12 13 14 15 16 17 18 19

0  *                       12                                  

1     *                 9        14                            

2        *  9                                14       9        

3           *        14                12    10                

4              *  12 10                12 14                   

5  9              *     9                 14                   

6                    *                 14                      

7                       *                                14    

8                          *                          12       

9                             *     9              14       16 

10    9                          *  10                         

11                9                 *                       9  

12                                     *  10 9                 

13 9                                      *                    

14       9  9                                *                 

15          12 10    11                13    9  *  9           

16                                                 *        14 

17                                                    *        

18                                                       *     

19                                                          *  

